7 10 1 1 7 7 7 2 6 8
2 10 6 8 6 10 1 9 3 9
2 8 8 6 1 9 4 7 6 4
5 5 3 5 5 2 4 3 5 9
3 9 8 10 6 3 9 9 3 4
7 5 1 7 10 1 5 5 7 2
8 4 6 2 10 3 5 3 5 10
1 9 8 10 9 5 4 7 3 7
10 2 1 10 8 2 2 4 6 9
5 5 4 1 8 3 3 3 8 9